ACE	EY S
CLUB	K L AH B
CLUBS	K L AH B Z
DIAMOND	D AY M AH N D
DIAMONDS	D AY M AH N D Z
EIGHT	EY T
FIVE	F AY V
FOUR	F AO R
HEART	HH AA R T
HEARTS	HH AA R T S
JACK	JH AE K
KING	K IH NG
NINE	N AY N
OF	AH V
QUEEN	K W IY N
SEVEN	S EH V AH N
SIX	S IH K S
SPADE	S P EY D
SPADES	S P EY D Z
TEN	T EH N
THREEE	TH R IY IY IY
TWO	T UW
