ACE	EY S
ADD	AE D
CLUB	K L AH B
DEAL	D IY L
DECK	D EH K
DIAMOND	D AY M AH N D
EIGHT	EY T
END	EH N D
FINISH	F IH N IH SH
FIVE	F AY V
FIX	F IH K S
FOUR	F AO R
HEART	HH AA R T
JACK	JH AE K
KING	K IH NG
NINE	N AY N
PASS	P AE S
PILE	P AY L
QUEEN	K W IY N
REMOVE	R IY M UW V
SET	S EH T
SEVEN	S EH V AH N
SIX	S IH K S
SORT	S AO R T
SORTRANK	S AO R T R AE NG K
SPADE	S P EY D
TEN	T EH N
THREE	TH R IY
TWO	T UW
