ACE	EY S
BLANK	B L AE NG K
CHANGE	CH EY N JH
CLUB	K L AH B
DEAL	D IY L
DIAMOND	D AY M AH N D
DISCARD	D IH S K AA R D
DRAW	D R AO
EIGHT	EY T
FIVE	F AY V
FOUR	F AO R
HEART	HH AA R T
JACK	JH AE K
KING	K IH NG
LEFT	L EH F T
MOVE	M UW V
NINE	N AY N
ORDER	AO R D ER
OTHER	AH DH ER
PASS	P AE S
QUEEN	K W IY N
RIGHT	R AY T
SEQUENCE	S IY K W AH N S
SEVEN	S EH V AH N
SIX	S IH K S
SORT	S AO R T
SPADE	S P EY D
SUIT	S UW T
TAKE	T EY K
TEN	T EH N
THREE	TH R IY
TWO	T UW
WAIT	W EY T
